WWWWWWWWWWWWWWWWWWWWW
W0000000000000000000W
W0000000000000000000W
W0000000000000000000W
W00000D0000000000O00W
W00000000000000O0110W
WWWWWWWWWWWWWWWWWWWWW